24 23 24 22 23 24 21 24 23 21 23 21 23 23 21 24 24 22 23 21 23 22 
21 14 13 12 13 12 13 11 13 14 14 11 22 13 11 11 14 11 12 13 13 21 
23 13 11 14 12 22 21 22 11 14 12 12 23 13 23 23 22 11 11 11 14 23 
21 13 11 11 24 22 12 23 23 13 13 11 23 12 21 13 22 24 14 12 14 21 
22 14 12 23 23 13 12 14 21 21 14 14 22 13 23 14 12 22 14 11 13 22 
23 12 14 24 14 11 13 14 11 23 22 11 24 12 23 21 12 22 12 12 13 23 
23 14 14 23 11 12 23 13 13 12 24 14 24 11 12 23 11 21 14 13 11 23 
24 11 12 23 13 13 22 13 14 12 23 11 22 11 30 23 14 21 14 11 11 24 
23 14 13 23 11 14 21 11 14 11 21 11 21 24 13 22 11 22 14 11 14 23 
23 11 12 21 11 13 22 14 13 11 23 13 14 22 22 22 12 24 14 11 14 23 
21 12 11 23 14 14 24 13 12 12 24 13 13 13 13 14 11 22 12 14 13 21 
24 14 13 23 13 22 23 13 22 13 22 22 11 12 14 14 13 23 21 14 12 24 
22 11 12 24 13 24 11 12 21 12 14 23 23 22 12 12 12 13 23 12 12 22 
22 13 13 21 12 23 12 12 24 12 14 13 12 21 22 12 14 13 23 13 13 22 
23 13 12 23 13 24 14 14 23 14 12 13 13 13 21 14 14 13 23 14 12 23 
23 14 13 21 14 24 12 11 24 22 24 12 11 13 21 12 12 12 24 14 13 23 
21 14 21 21 11 21 13 14 13 14 22 12 12 12 23 13 12 12 22 11 13 21 
22 12 22 14 12 23 21 23 22 12 21 24 21 24 21 13 12 23 21 14 13 22 
23 13 21 14 13 13 14 40 23 12 14 14 12 12 11 14 11 23 14 14 14 23 
22 13 22 24 21 24 21 22 22 24 21 22 22 24 21 24 22 22 14 11 13 22 
24 13 13 14 13 12 14 11 11 14 12 13 11 12 12 14 13 14 14 13 13 24 
24 23 24 22 23 24 21 24 23 21 23 21 23 23 21 24 24 22 23 21 23 22 
