24 21 22 23 21 24 24 22 22 23 23 24 22 21 21 21 24 22 23 23 23 23 
24 30 12 12 11 11 12 14 14 12 12 13 12 11 11 12 13 12 13 11 11 24 
22 23 22 22 21 24 23 23 22 21 23 24 23 21 22 21 24 23 24 22 12 22 
21 13 14 11 12 13 14 14 13 12 12 12 11 14 12 12 11 12 14 14 11 21 
21 13 23 21 23 24 22 22 23 24 22 21 24 21 24 22 21 21 24 24 22 21 
22 12 12 14 11 14 12 11 13 12 12 13 14 14 11 12 13 13 11 11 14 22 
24 22 23 24 21 23 22 22 24 21 24 23 22 22 21 23 21 21 22 24 14 24 
23 13 14 11 14 11 11 14 12 11 12 11 11 11 11 13 11 12 12 12 12 23 
22 12 22 23 23 23 24 24 22 22 22 21 23 24 24 24 23 22 23 22 23 22 
21 13 12 11 14 13 14 12 14 13 11 14 11 13 11 11 11 12 12 14 11 21 
22 21 24 22 24 22 23 21 23 22 21 24 23 23 22 23 21 22 23 21 12 22 
24 12 13 14 12 13 11 12 12 12 11 12 14 13 13 11 14 11 13 11 13 24 
21 14 21 23 23 22 21 24 24 21 23 21 22 22 22 21 23 22 21 21 23 21 
21 11 14 12 13 12 13 14 14 13 11 14 14 11 14 13 14 14 13 14 13 21 
22 21 24 22 23 22 24 24 23 23 22 24 22 22 24 23 22 23 21 23 12 22 
24 14 14 11 11 11 14 14 13 11 13 13 12 14 13 14 12 12 11 14 14 24 
24 13 23 24 23 24 22 23 24 22 21 24 23 22 22 22 23 23 23 21 21 24 
22 14 11 11 14 12 13 11 14 11 11 13 11 12 14 14 12 14 11 14 14 22 
21 22 23 23 23 22 22 24 22 21 22 21 22 23 21 23 23 21 23 21 11 21 
22 11 14 13 14 11 23 13 14 13 24 12 12 13 23 11 11 13 23 11 13 22 
21 40 13 23 14 11 12 11 23 13 12 14 21 12 12 12 21 11 12 12 23 21 
24 21 22 23 21 24 24 22 22 23 23 24 22 21 21 21 24 22 23 23 23 23 
